1111111111111
1000C0C100C01
1111110001111
100000P000E01
1C11001010111
110000C100011
10000C1001111
1C100110C0001
1111111111111
