1111111111111111111111111111111111
1E0000000000F00C00000C000000F00001
10100101001000001010F1000000010101
1010010010101010001001000000010101
1P0000000C00C000000000000F000000C1
1111111111111111111111111111111111